
                                         #                  ####### 
                           #             ####### ####  ######     #### #
                           #                     #             #       #
###########################################################################
###########################################################################